x,x,x,x,x,x,x,x,x,x,x,x,x,x,x,x
x,o,o,x,k,o,x,o,o,d,o,o,o,o,w,x
x,o,o,x,o,o,x,o,o,d,o,o,o,o,o,x
x,o,o,x,o,o,x,o,o,x,o,o,o,o,o,x
x,o,o,x,o,o,x,o,o,x,o,o,o,o,o,x
x,o,o,o,o,o,o,o,o,x,o,o,o,o,o,x
x,o,o,o,o,o,o,o,o,x,o,o,o,o,o,x
x,o,o,o,o,o,o,o,o,x,o,o,o,o,o,x
x,x,x,x,x,x,x,x,x,x,x,x,x,x,x,x
