x,x,x,x,x,x,x,x,x,x,x,x,x,x,x,x
x,o,o,o,o,o,o,o,o,o,o,o,o,o,o,x
x,o,o,o,o,o,o,o,o,o,o,o,o,o,o,x
x,o,x,x,x,x,x,x,x,x,x,x,x,x,d,x
x,o,x,o,k,x,o,o,o,x,o,o,o,x,o,x
x,o,x,o,o,x,o,x,o,x,o,x,o,x,o,x
x,o,x,o,o,x,o,x,o,x,o,x,o,x,o,x
x,o,o,o,o,o,o,x,o,o,o,x,o,o,w,x
x,x,x,x,x,x,x,x,x,x,x,x,x,x,x,x
